NO ./test_file/north.xpm
SO ./test_file/south.xpm
WE ./test_file/west.xpm
EA ./test_file/east.xpm

C 225,30,0
F 10,100,0
1111111111111
1000000000001
1000000000001
1000000100001
1000000010001
1000000001001
1000000000001
100000011000N
1000000010001
1000000000001
1000000000001
1111111111111
